####################
#####..........#####
##....####.#.#....##
##.#######.#.##.#.##
#..........#.......#
#~~#.#.########.#~~#
#XY#.#....@.....#WZ#
####.#####.####.####
#.......##.........#
#.##.####..#.#####.#
#..#....#.##.####..#
##.#.##.#.##.#....##
##.............#####
#####o########o#####
####################
bgimage gfx/bg1.bmp
bgmusic sfx/bgmusic1.mp3